C 1,255, 30
F 1,255,30

EA ./path_to_the_south_texture.xpm
NO ./1234.xpm
SO ./path_to_the_south_texture.xpm
WE ./path_to_the_west_texture.xpm 


011111111111111111111111111111
11111111000000000110000000000011
1011000001110000000000001111111
100100000000S0000000000001
1111111110110000111000011
100111000001100000123431101111
1111 11111111111111111111