NO ./1234.xpm
EA ./path_to_the_south_texture.xpm
SO ./path_to_the_south_texture.xpm
WE ./path_to_the_west_texture.xpm 

F 1,   255, 30                  
C   1,   255, 30 

ghbdrhn


1111111111111111111111111
        1000000000110000000000001
1011000001110000000000001
1001000000000000000000001
1111111110110000011100001
1000000000110000011101111
