NO ./1234.xpm
EA ./path_to_the_south_texture.xpm
SO ./path_to_the_south_texture.xpm
WE ./path_to_the_west_texture.xpm 

F 1,  255, 30                  
C   1,   255, 30













0111111111111111111111111111111
11111111000000000110000000000001
1011000001110000000000001111111
100100000000N0000000000001
1111111110110000011100001
1000000000110000011101111
11111111111111111111111