
F 220    ,     100    ,   0
C 225,30,0
NO ./1234.xpm
EA ./path_to_the_south_texture.xpm

SO ./path_to_the_south_texture.xpm
WE ./path_to_the_west_texture.xpm

1111111111111111111111111
1000000000110000000000001
1011000001110000000000001
1001000000000000000000001
111111111011000001110000000000001
100000000011000001110111111111111